###################################################
#   #           # #       # #               # #   #
# ####### ####### ### ### # ### ### ### # ### ### #
#     #     # #       #     #   #   # # #       # #
# # ##### ### ### # # ### ##### ### # ##### # ### #
# #   #   #       # # #   # #   #     # # # #     #
### ##### ### # # ####### # ### ##### # # ### # ###
#     # #     # # #   #           #         # #   #
### ### ##### ####### ### # ######### ### ##### # #
#         # #       #   # # # # # #   # #   # # # #
### # # ### ### # ### ####### # # ##### # ### ### #
# # # #       # #         # #       # #     # #   #
# ##### # # ##### # ####### # ### ### # ##### ### #
#     # # #   #   # # # # #     #         #       #
# ### ##### ##### ### # # # ##### # # # ### # # # #
# #     #       # # #         # # # # # #   # # # #
# ##### ### # ##### # ### # ### ########### #######
#   # #   # #     #     # # #           #       # #
# ### # ##### # ### ######### # ### ####### # ### #
# # #       # #   # # # # #   # #   # #   # #     #
### # ### ##### ### # # # ### ##### # # ##### # # #
#       # #       #         #   #           # # # #
### ### ##### # ### ##### ### ##### ### ######### #
# #   # # #   # #   # # #   #   # # #   # # # #   #
# # ##### ### ### ### # # ### ### ##### # # # ### #
#     #         # #         #     # #         #   #
# ### ### # # ### ### ### ### # ### ### # ### ### #
#   # #   # # #   #   # # # # #   # # # # #   #   #
# ### ### ##### # ### # ### ### ### # ####### ### #
# # # #     #   # #       #       #       #   #   #
# # ##### ##### ####### ### # # ### # ### ### ### #
#   # #     # #     # #   # # # #   # #   #   #   #
### # ### ### ####### # ### ##### # ##### ### ### #
#     #         # # #     #     # #   #   #       #
# ### ### # # ### # # ##### # ##### ##### ### # # #
# # #   # # #           # # #     #   #     # # # #
### # ####### # # # # ### ### # ### ####### #######
#         # # # # # # # #   # #   #     #   #     #
### ### ### ########### ### ### ########### # #####
#   # #     #   #         # #       # # #     # # #
### # ### ##### # ### # ### ### # ### # ##### # # #
#       #   # #     # #   #   # #         #       #
# ### ### ### ### ##### ### ##### # # # ######### #
# #   # #       #   #         # # # # #     # # # #
# ### # ##### ### ### # # # ### ####### # ### # # #
# #     # # #       # # # #           # #         #
# ##### # # ### ############# ########### # # # ###
#   #       # # # # # # # # # # # # # # # # # #   #
# ##### ### # ### # # # # # ### # # # # ####### ###
#   # # #     #             #             #       #
# ### ####### ### # # # ### ### # # # ### ### # # #
#         #       # # # #       # # # #       # # #
###################################################
